  --- --- --- --- --- --- --- --- --- ---
|  10  27   5   5   8       5   9  17  10
|   2   2   1   1       5   2       2  11
|       7   2   1   9  11   5   2   4   3
|                           1   3   5   2
|                           1       2   1
|                           2           1
|                                   1    
|                                       1
|                       1                
|               2   7                  28
