  --- --- --- --- --- --- --- --- --- ---
|  27   4   3   3                        
|  14                                    
|  11                                    
|   4                           1        
|  14                       2           2
|  18                       1   1        
|   8                                    
|   1                               1    
|   5                                    
|   7               2           1       4
