  --- --- --- --- --- --- --- --- --- ---
|   2   1   4           1           1    
|                               1   1   2
|                       1       3   6   1
|                           1   1   1   2
|                               1   3   1
|                                       5
|                                        
|                                        
|                                       2
|                           1            
