  --- --- --- --- --- --- --- --- --- ---
|   9  14   8   3   2   2   4   6   5   4
|       1   2       2   2   4   4   1   7
|               5   4   2  10   2   3  17
|                           2   1   1   4
|                           3   2       5
|       1                               9
|                                   1   2
|                                   2    
|                               2   2   1
|   1               2               1  27
